lrz: gjb vfq nvd qsf
lfr: btf ccz xzp
tpf: rsx xlq fhm dqr
blz: zqs lzl lkh
gqq: rsq mck
cph: jth vbr
zbl: rrm qzm tnk
kcg: xvk ftz cnv mlc
bhk: bjr tsp dtc rlk
dvz: dcx hrx
qgn: xzp jxq
kxx: kdz mzx
hmx: kdn fpb
tzq: xgk gbd
srg: tgs fhr hpb sxr
srf: tql jdz jvm rst
vcg: mmb gpp dbz
hlk: bxm sqv zrv
lcb: xrl hqq ljp
jvp: rbm dqr rpd zfc crl
hrp: qlg pxv xzs
dpk: ngd kfb jrr
htj: dlj
mnr: mgp tvz bxb jvk
cbg: bxd
sxr: mzc ghk
rdc: gqq llx pnv
xjk: jlr zcs
dvq: brp drx rpb tdq nkg
jdt: lhv hlz
ngj: vsc nff
qsr: vfj jpr qzp
zbp: kdr
fjh: xbl vml jcc
fsg: hzp gqj fjr hzj
cfx: rsq
sfh: gxb hln qbv
zfm: jcm tvz tsp mjn cbn rlz sgj
hhm: tjm phz vrp gcz
pvs: rtf nmn lkh
prp: jpm tnb mqk vdx
rls: kgs dvf xvj clk
jlj: zhn xlc
prh: hpb cph fsm nfc
vsx: hsh plr ntg zmj ddk dmj hmh
cps: crl ktg fbt vml
zgb: vjg
kvc: ssm kzs gkv hdl
qmx: dvq gln glp tmb fxr dzq kfc
xnx: kxt gct xtn
vpq: jcm qjf cxx
lgc: nqg
ghm: srt
brx: mqt qxx nqg
tsb: qdc fnx gdl
ghv: zfx hbk fbd fxn hbt
jjl: fbs
rnl: jgs vqv
cnv: tjg vjj bpp vqn
xjj: cbj xvh
mjq: zgh fcq pfq
dqm: brm
pjj: gpl
zdb: tsx rsg qrj pzm
dtd: qxc kdb qcm pxq
brh: qxx ktv
xfx: vmx qbj fbl
rlz: zzp
qxd: qsn zfq gqq sfs
gkc: mlc trs qmn hzj kfq
nfc: rrg znf bbx znk
mfx: drb
kqc: fjr jzm ndt
fgq: ppd
fpf: bfb fqh xzg
bnn: rcc dsm pll csp
ctf: rbd kgs rls fqh
lrf: grl blf fln
tjj: lfj
crf: rbx
gct: ksq
nhg: phm zfc
qhv: nhp
vhv: mqm
dhf: bcv
tvj: qbh mfs kzz lcx rgc
pbg: tzx vml pkp bcv
gdl: nnk
jqg: drd zzn
dzn: zfc pcx hqh snt txl qzd
lxt: phq lpl
vfn: tbv mhg lfx
hpv: lmf rnl
vfh: fbt jdv
sst: bhx hbm knr tsk
jsg: vzp fkz
vfb: brp vhh ppq pkf
bjh: qnx pxk
jfv: nmg ldn
klt: kvp tfx xjj fjt nvq
shf: ltp tqk
kfj: vbp qst
bxb: pxv
gxt: vpg msz
rsj: zqh lzf ngg mjq
stx: nms gqj mql
zhm: nms rlt glf hgq
csz: kgs fzg tfv fjp mtj dqk dqd
vgb: xrv nfj hkj dtd
jlq: ltf
nqx: lhn dpr
xzv: ngd kkt qzp krc
grh: krm
bms: rch vhh qvc vmd
xhs: jjl bvr
ggs: dbz pvh mcj
qdp: qvc
rpr: pvh tvh lgc xpt
cmf: vqv
nbg: plb kfc zlg
tgs: kdr qvd
nvg: cjb fvk gkl dpk
xfj: rhz mcn glb
lnq: xhv
ktc: ptr qdp rdt
kgq: zrv bnv cbg
drd: xsr
pvh: bpp
sbg: jdk mzm slf
dnz: zcs hkd qgq
brp: xhh
lxs: mtd
stj: pnd
mcv: bbg
znq: hhv
fpt: vcd dhk zlm
grl: qgr
hsg: sbv
mqk: flq txx jpn xbn
bdv: mzk hkd gfm nvk
vrb: jxt dtv src
dvd: vcd nzv kfq ksj
vht: gvg jxn
tpq: dnq jpx rst mxc czp jlr
ltf: hhv
cln: zjc
ghk: xxq
lxz: msp cgl dlz
kcf: sdv
gjb: jlq
jrk: ntv
sdx: ksq
tdq: xvh
hdd: zgh
tcx: rjc cjb
pxl: vml lks
tnf: xcf kdr hls
vlr: fxg dlz gsf
gtv: xfl mkg ngj
mxs: drv blb
xhf: rnl vqv vzj gtq
zrq: qvm fpt
kfc: ndd
jzs: cqg
ldk: tsx tqt grh mql zrq
cdh: qkn jpn xdq
zjc: tgp rvn cgl xcs fjh
zcs: rhg
xvj: mcq
kzn: rkg qlg
tsk: sgr
cbh: vmd
zjh: gxt qrm jxn fpb
sjd: kmz znv mrq zfc
rfq: pzb rqx znq kgd
ddt: xnk dsm xhh ngb
svd: bvt znq
htp: mjn kzx
zjq: tvz phn clz vzp
tvl: tjz kjf flc gxx
xmt: qqx npq npm mdx pqj
mxc: htj
jmn: sdx tvz flg
bqg: kqp mnd lgl
xpt: lxz ppd dkg mck tvp
rrm: ltf
tgc: zbp glf
mfv: src hpq qxx jtj
mjn: tms
fbv: dbh kcr nvj krh shf
xkb: xgz xnp
gqh: pxq gns tcj
rqr: ffg gsn
ktg: rsq
xpn: mtv vvs
cvz: gjb jxq
ntg: brr kjl brm
hpq: mcj jcc nzv
qhf: vmd cqg vtv
fpq: xbm qgj svn jsp
trs: lfj
fhd: qcs tjg
xxj: znf lrp hcb xmv
kff: vbk vml stj gkv
lbr: vqv zrt qxz
mzk: qxz cbj
dzq: hvq ntv
qzp: pcq fjr
vhc: gxb smr
gmv: jqg xlv
xzx: zrn fpd gbd
bxm: hkd
qdl: pcv
scm: mgf qrq pcv nfj
srj: lfl vbr kjf cdq
ghc: bhx
jjf: qcv grm
bcj: vpg mjm fcc
tlr: snx pnv lgl
zrv: tkf hst mfx gqm vbh
lhn: jtl bfb sbc
ltj: jdd glp hpv bdj
dxk: frf hcj vfn kjd
qxh: qbd ltn
chh: rxb
lkh: cxt
mdf: kmh qmv
nfd: fzf lpl
hzp: tjg hsz
hzn: ddx nfc mnd bfq
qbh: hdt ncm
rxc: btf
plc: xbr xhv
mth: sbt hhc jxt tgc
kqp: nch
cdn: clk nzt shv dsv
frr: mzm
lmf: fbs hjf
cgn: crx fxx
kjd: vpg ffs gcz
zrb: qjk nnn fcc jpl
njj: gcd
vtv: kdn
nfn: rdr gtq xnk bgj bxd rmh
tgq: pnd hxj
dkj: xgt qjq bnm
rtz: dpk hcb qvd xnx
cnm: gld zcs xqz
thc: qjk ksg kdn
nzt: srt qrr grm
ngg: jpl
qps: rtz dlz vjj kfq
rvv: stj hlx hps ssj
qnx: zgb hgk ltl lnq
lvn: qbj
kzq: hpk rjc cch
ncp: mlc lml ssm bpc
dvf: krd vbh
tfx: crv msz svt mlg
tsd: mtv
mcs: xxd hcn gkl xcs
dmp: src zfq lcb
hpk: jvz
ggr: kzs fgq gns rkg
mqt: sgj jzz tgp
rdt: zqs cjh
qcf: mjm
bhf: qjf jdv
sxs: svd mfx xkn hhv
nlb: rbx dhq xvx jlj
lhf: kjl lxs zgx
qxb: tmx hjv
bxg: vzp
zgx: rqt lcn dlz
dnq: ccz
fdn: hsz mzx
tmh: rst
pnz: dxq vkn dxx
ntm: jvm tnk gcz
tmv: rxn slk tvp vfl
zdn: cjm chh zzn
bnm: qsf
fjk: rbm hdl blm xhz
blt: ztv jgm svn
kxl: mnr xcd xxb
lhz: xlm bzm
jpn: csp
kzz: svg
gmj: htj
nmg: vbk bbg dqr lxs
sgh: hzj gfr
sjr: lhf hhc sfs tcx
cxn: mqf
spj: ntf lzl
blm: cgl
vrl: hvk ctm tmx xdc
jqx: txf bhz nfs
jkm: qkt khb
cfz: dqk mqg ljc crx
rqx: lqh
krj: lgl gsn rzh xjv
mfs: fdl xhv tpq
gbv: bsq flz jfd
bvr: zlg
dlj: hjf
hds: rnf fdl gqm cdl
tfh: znb pgs mth qdl
flc: lgl snx
zvp: jdv rqr qdj ddj qcs dxx dqr
mdc: mql jxt vkn qvd
hcb: lfl
klm: gxv lpq jth kzb
jvv: rbd prs qlp
jcm: pzm bsx
kqj: bpg skz hkh bxb
xlc: gxb lhz
llh: vfn lhz pvs
bzg: nhq dtq
bql: clz gmm dtq mzm
xnr: gxx bbg hkt
fqh: zjl zsd npb
dtg: khm gsn tdz mql cdx
lts: ltp gcs mbr
msp: xtd
pkf: zkj hkk mmm
dtc: bpp
rps: kfb kzb
xzb: tvp zzp fpc tpd ndt
mrq: fxg
cch: gfr gkv
mfb: gpz
flm: hdt gcz rrm jpb
vdf: rkk lzl drx mbv
kmz: jqx ldj nfj
svg: mqm
ckj: zqx sdx vpp mzx
vpg: crx
bfq: mrs hqs
qtn: dnr zgx hpk
ksj: zzp
kvm: fhd lpl xfl stg
rmz: fvk bbg bpg
pnd: bpg
glp: cpd
xvh: fqx nvd
gch: qrj stg cnc jcm
xdc: vmx
zdj: hvc kvh cpc cln mzm
mfg: blh csc kzm kgh stn
rtf: vfk xvx qkn
xcg: zhc fmn
ndg: lxd bsx fnq
sfx: sdv hbm qmv gnv
vrp: kbk jrk
llk: csc stn rcc svt
jlk: cln mzv lpj ncs
xrl: bbg
hjs: vlj dtv bcv
tbs: njj pvh
fxr: rch hbm qkt
vpb: nhq bxg rlk
grb: ckr srl tjj nrh
lhs: hmx ptr
lss: tms pxl
dmn: gjb qzm knr vhc
hst: mtv
xph: blm dnl kzg snt
hzk: gsn cdj stg rjc
qxg: mjk fdl rxc
fck: hpd qrv ntn nbm
kgs: dvf
ptb: bkz gtv qxc lrj
rll: rsq hqq sts
mkg: ljp
tpp: dms tqm kcd xjv
bgz: jlr qcf qqx cxt
flq: drx cjm
dsv: jjf sgr ptr
ntd: ksq
bzh: frf prc lfr
fnn: bgz fsh gcz
zzh: djk xhf xsr bhv
trb: qbh hnd khb tkf lnq
jdd: kgh jgs ccg
hsj: qxz ntv qvb
npd: zfx svg
mff: zrc jrz hkt hkj
jrq: sbc
fnk: bhx vhv
mst: nvd
sbt: sbv
rkc: znk szr
pkp: nfd jrr
bvm: tmh gmj mgk xvj
ppx: xbr hkx hdd
dqr: qcs
nvq: fln lfx gnv
rjz: tjj nhg znr jnp
znr: ljp ttv mcj
zzn: zlg
pjv: fmv
sjp: blb jmn bhf xcd
hzf: ftd plc ltn
xzn: kjh krd jqq
hbc: rhg zzd zcs
jgc: jsg xtn tsx
znf: rbg
xfh: sqv
clg: grh tgq sdx jlk
cgb: qjf kdr
qxl: bhb zct src
bbx: qgt fkz
pqj: gfm kvp xfh jxq qmv
lhv: glh
gxx: rps hvc
nvk: gcq
rxr: xlm kzm nhz
ksv: jsn kjd
mjk: tmx qsp cxs
qbj: hkx
fzg: vfk fpd mqm
gpx: cbh rkk qgn qst
mpb: qgr pxk lfx qvb
xmv: ltc zqx lhv
kdg: qgr lcx szm
bcs: lpx hgh
tzd: klm gbv nch
rbm: htp ksj fct
mdx: kcf xqz fjp
fjp: fxx
tpt: cch nkh szr
kph: lfj bsx
lkp: sbf slk krc tcj jdg txf
qgj: gpz ftd jkn
rft: jpn frf
znb: mcv sdx
dbk: lfr
pxq: qgt nhg
llx: czr qdl xrh
tgp: fjr src
xlv: qkt frg
vnc: zct znb xxd
qgq: ntf kcf
drv: vns mrf
qjq: mlg
rts: nks vnc zcr qrq
xhd: cbg fcc vjg
jsk: lmf qkt ngg dkj
rxg: vvg hpx
dpc: hpv jdh rst hkk shv
dbz: pcx pxv
qnm: bzm xfh
phn: qrf
ldn: clz cjb mzx
blb: rjc
fzc: kqp cfx jfk
sbl: tql xgk ngb zkj
bsq: mql kfq tqk skz
jcd: gpl fbt lml pjj
qqg: spn kbk dbl
pvd: mzc vqh
bzr: zgb tkf
tmf: dvt dnr hmv ndg
zxt: tsj cbh jpn
qnv: xbc zjk cbg ltn
kps: hpd xfs tdq hvk jqq
tph: ztv hxh gnz npb
hmv: rps tjz lbz
rgc: qgq ppj hvq zrn
xlt: crs kxl dbz pcq
hdl: jcc
gld: qkn
nxx: tmh
qsn: msp slf vnp
trz: nhp jlj cdh spn
zdg: rhz ngx jpj vdx ckp
dsh: tjm dqd rbd xpn
pgs: dcx btp
jsp: vdd dvc
pmd: fzf jsg vbr
krd: qqx
sdj: xgt qnm gdl sqv jkm
crs: gjd sts
jfk: stj glf hdl
jxn: ncm pzb
vkn: qgd
jfd: tlr mxs tpd
fln: cxn blh
vst: hvk sgk ntm
ztr: xhv hzf pjv xsr
hjm: zbp znv
mzq: zpr vfl drv
rkq: bcs kzg hgq xsj
mrs: ksq
nhv: xnp ccz ncf
gdh: lkh bhv xzp khx qlp
hgh: kjl
hsb: ncf hdd nzm
xps: ghm tsb tmh
ntb: tqk vzp
cxx: frr bzg
mqc: mtv cxl chh fcq
pxk: gnv fnx
dmk: glf
ncs: tjg zmj hcb
dnr: zzp
hlz: nvj
ftd: cxl
zxs: qlp ngx jsk lch lvn
vpp: tvp tbs dlr
qrx: cjh xgm kcf bhx
qgc: pbp xbr fmv ntn mxc
cxl: xbr
mnh: mxn jgm qgc srp
qkb: qbd bxm fzr
xbn: crf prc jqg
bgj: dnq
tbx: dxs dqp khn xbl
ljc: nhp hjf
gtk: znj hgq
jvz: ssm
mzl: fpc vkn ncj nch
dkd: ckr vfj hqq rbm
bnj: nmh mlc fhr
plr: xcf
qrd: chh vtv dvf vbh sbl
rsh: kjh bfp hpd gkp
kcr: tbs rvn mtd
qcm: khm kdr
kzs: hrx
khz: fzf shf tjz sbt
svq: kmg gln mcq lqh
bkl: lmc rlk hzn vsp
kmh: mtz bgq
fxn: xlc fnn xhs
hxm: zgb bnv mdd qsf gqn
hgl: xqz
skh: ncm jpb rcc
kkc: nff dbz nfd dmd
gbd: dhq
kzg: plr bnj
xbm: tzq qcv
vbr: vns
bdj: vfh zlc vvj xfh
qzd: vvg dqp nhq
lkf: rnr csc
ztt: gtk
lzf: nnk svt rvg
pll: tnk ccg
ddx: rvn frr znj fzf
tzx: mzz lpx mmc
vsp: mcv gzb vdm
gmp: rmd
hlx: dcx
fbz: jlj nbv dbk ppj
nhq: hvc tms
tqk: tvt hmf
vdz: xfx hjv nxx
txx: fmv xpx ldr tsd
dbl: mcn zzd mxc
rnx: qrf hmf
tjm: cbh xvx jqp
prc: sdv vdd
tjk: srt qdq xbr
drs: jkn mqm
qrv: plb
nmn: fxx ncf vht
zsm: jvk lxb tcj qbc
jjs: crf gcq vbh xhf drb
zdz: btp tvp fzq lrp rlt
ztc: qgr ffs qxb mtj ttv
pcv: vsc
bhb: ddx gjd pgs
kcj: kdg qnf spj ltf
rkb: bqg rnx flk nks
hxj: qxx
kpl: cln vsc pbn dhb
mtz: dpg hst
jlv: kph hpk mjn
rhl: qzm zgb ksv
txf: hzp cnc
pkx: mns sqv drd
dlr: mzc ljp
dmd: mkg dhf mgp
fqx: xnp xsr
pzf: blt mcn
nrh: vns
jqz: mxf xnf csc cjh vzj
jtx: mrf mkb vkn
qvm: znv
lmq: vhf vns vvd tnf ndg nrh
xgd: gmp qxl hlx fsm
kjh: vhv qvc
xcs: kfq gct
sbn: tnk nnb ztv hvr dsv
zzd: gzg kgd
fnq: pnv kxx
nbv: ltf lnq
gqf: dqk
vfj: qgt
hbm: qhv ccg
nnn: ntn
ddm: stn xkn xps jpl
dmj: djn ztt tgs nks
xlq: pnz znj rdc tvt
glb: qjk vjg
zsb: trb vjg xjk gqf
phq: vbk ndt
nfp: qnv xlm ltl pfq
dsm: dlj jrk
vqh: gtk xvk
cbn: lpx pzm
hgz: crs hcn xrh qvm dms vpb
str: fpc gcd sfs vfl
jgm: nhp
jpm: jxq
cdl: qcf ncf
tsx: fxg ltp
lkj: jqq mqg qpj xzn bgj
khx: hgl lcx
ljn: bzm mgk
cdq: vfl rrg cdx
jtj: rjc xqt dms hkt
szr: slf pcx
fhv: bts xhf lkh ksg
zlc: pnq xvh
qbv: jqp zhc hln hcj
snt: jzm nqg
hxh: rhg bhv
hcn: dvz txp mrq
pbp: jzs npm
rjj: cbh fxx
tbg: hzn ghq rgp nlc
hlq: hpk jxj cpc kcr cbn dnr
ndd: xnp plb
jxj: rnx kfb dqm
bjr: hsg phq
mxn: lzn fcq hnz
xdq: cxl hdd lhs
txr: bfq frr lfl
hxb: lml hjm ndt kjf
lkl: xsr vhc vfq
dpg: qbj
fnt: nkg vht spn sdd
clz: cgb
cnc: dcx
sgk: fdl jrk vmd fbl
gsf: fpc flz qmh
njx: pkp kzb vsc
tmb: vfk znq gmv
gpp: dtv
bgf: zbp shp flf rlz hjt
kfs: kmv msp nms
npt: grl mcq zqs lvn
hjt: tvt
jdj: nks kzs ksq bhz lcb
ctm: hsj rht xfj
gnt: thc svg ljb qvb ksg
hvq: fnk
gln: npb
cmc: phm qrq fhr
qzr: txf dcx qzj pkp
dbt: qst rqx
cqd: ktg nts vhf ddx
mgf: gxv qcm btp
ktf: pzb ksv xzp pjt
cbj: fmv mcq
sqs: llr jcc xrh
hfq: zbl qzm zkj khb vpg
rxn: gxv blm xrh
ljg: gdl khx vzj
kpk: tcx vzp fzc zkg
mbr: kdz pxl ssm
xtd: xcf gkl
qkv: rbd xhs glb
hfc: cqg zrt jsn bgq
vdd: zjk hln qvc
qgd: ltp
czr: hmr pgs znv
rlk: gqq lrp nmg
khm: mkg
crl: gjd bsx pjj
dkg: kdz mrs bpc
zcr: zpr hqs lhf bcs vhf
mcn: hjf jgm
csf: bhx svt
khn: mkk pnd
htv: hkk pzf ppj jrq cxm
cpd: pjv kgd xkn
npp: slf hsg xvk
jkn: mqf
shp: brh lgl
bgn: shj zmj ltc nzv
zjk: lcx
rgn: gkl
cjm: qhf hnz
kmg: vbp cqg
mmk: jnp rkg jzm
mqg: vmd brp qrm
gcs: lgc llx
nbc: mlg fbs vvj gqf
fmj: pnd gpp mkk
ltl: qbd hgk hbm
dxq: nfs
vvs: vhv
rvp: mfb gbd
vfq: qjq qkn qjk
txl: pxv rkc tgc gpp
kdj: jkf txf qsr qxx
msn: dxs zrq tpt hzj
nlp: mck czr xsj jtm
tcq: jdt gmp xrv cnt
tnk: xzp
cpc: lgc mck
zjl: nzt dlp
hkt: glh
mcj: plr
fkd: tsk clf kjd zrt
cjh: qsp
nnb: vhc fzr
qdg: csc flq nzm trb
nkg: ghm nqx
spp: rft cvz jjf btn
jrz: vnp hmh rvt rrg
cxs: fpb ljc
fzq: flz hpk zjb
xhz: hsz rvv mlc
cdj: phn
fmn: gvj
ngd: phm
tvh: nlp gns gmp
dqd: zjk
hkj: qmn
qzj: lpx pvd flf
hbp: chc tbv glz
tbv: bzm xqz
dbh: stj
hnd: cxs mdf xnk
bfb: mst
hgp: nnb lbr spn tnb qhf
mjg: gzg xgk
cxr: sqx mnh tdq hst
mnd: qmn jfv
clk: xts nvk vmk btf
mgp: ldj tjz
lmc: fct bbg hrx
qls: mjk dpf dnq
zls: qmx qxg hvk hpd
tfv: gcz hkd xfh
lzr: qqg spj hbp pzf
mvl: nqx bnc srp rrm sdd
btd: pkx zdn lkf bxm lzn tnb
lzn: mjm
ntf: dqd
rnr: fxx cbj pll zrn
vhh: fsf rht jnm
tkf: xnp
mkj: npd smr svd xsr psk vtv
ffl: dxq vpq rxg dlr
lxd: xjv glh kzb
pjt: fnx shv mfb
kdn: dpg
kvh: lks snx
cdx: xvk
ztv: ccg sbc
bpx: pzm llx tgs khn
rvg: jpb dbt
nzm: csf
fvk: cgb qvm fxg
drx: fzg
ngx: ljc
btn: jpm qrm
qnf: bzh nhv kzz rvp
pfq: rqx
dhv: hpk kdr mjn
knt: ksz hsb tjk drs
tdg: nnn vdz qhv drs kzz
sgr: fpd
mtd: gct
vnp: ssj
qlp: plc jdh qls
ggz: krc kjf rqt rvn
lzb: zqh rhg frg
sdz: lpl dtq tgs hkn
tql: nnn mgk jpn
nbm: zrn
qrr: ntv rnf
kdq: fsf gvj gmv cjh
gts: tsd lrz fnk fbr
hrc: npd jtl sfh
kkt: brm hlx
nbb: mjg mst kbk vmk
crv: fqx khb
rkk: rpb jzs ghc
dpf: hhv jpb qbj qrv
mmb: hkn pbn mkb ngd
jdh: gqm bnc
mcq: bhv
mjm: gqm
sqx: bgj rvg tzq
gtm: sgh ncq kzx
gqn: jqp gvj ndd
gtq: tmh
hmd: rgn kfb kjf
hpl: czr zgx rmd dhk
qcv: znq
ffs: nvd
lhd: bhv vhh
fmm: rqr hgh qgd
bhz: hgh hls fjr hmr
lxf: rmz bxg
qdd: fmn hbm xsm
jdz: rhz
dbj: pjv zcj ljn jrq
svn: hkx ppj sdv
bll: cdj qbc hzk ztt
nkh: bcv
czf: mdf fsf hjv zrt ngg
qbc: vqn hmf
xgm: htv jvm qkv
xqt: xrl bxg qdj
ztb: qmh jkf hvc kph
xjv: hvc
dtq: qxc
gjd: fgq
fqr: ltn fjt xdc hcj
sbm: pcv glh ftz kxx
vjg: fbl
zdr: vkn vcd dxq rds
fbr: gfm svt
bmv: gzz vxr mst bkf vvj
qqz: gqn vrp
gzb: rps rzp rgn kcd gfr
jdk: fvk rkc mxt
dxx: xzv bpp dmp rll
dcn: hsh tqt mqt bkz lhv
qmh: dmk vjj
ghr: xzs nms hbz tsx dbh
hps: jvz kxt
brd: mjg xpx nbm
szm: xdc xbm kfj brd
lqt: gmm ffg lbz brh
lpj: kcr xqt tcx
ksg: fbd qrv
rch: tzq ghm hxh jkm
spz: svp jfv hqq zpr ngj
ldr: prc xjj cdl npm
vmx: pfq vvs
hxx: khn hjs gcs dvz
fph: qdq zbl mhg
zkj: kgq
gns: vbk vhf ntd
ttv: sbv
nmb: gpp vlr dqm
rzh: lbz jdt jlv
sgn: vfq blz glp xkn
dnl: nff jvz mrf
srl: ltc kqp kzx
skn: xcf rlz rzh ssj xzv
qxz: rpb xzg
pnq: zgh dvc
kmv: cdj xfl
sdd: kbk
btz: ftd hrc tkc jvv
mzv: zfq hlz xxq
zrs: bnm fbs csp tmx
bch: qxb lhd gzg lrf hmx cxt
glh: vfj
sfs: hps
vnb: hpq hjt lxt hrp
hkd: dpg qkt
cmn: msz fzg qqz
vdm: rsg kdb
qdc: cmf fbl
kdb: vjj lfj
vzj: vbp
rgd: bkf npb cxt rgc grl
xgz: nhz mgk blh nbg
tkm: mlc cgl mbr xcd
pbn: hfs hcb
gvg: rst tkf
bnk: fmm gqh jzz vdm sgh
rbg: qrf bpc fsm
jrt: srt jlr rxc bfp
gnz: kjh xkb hdt qxh
mkb: lcb
zcj: dbk xgt xkb xnf hln
hbk: rft lkf bkf
mxt: ktv znj
lmg: txf slk blb fnq
vrr: jdz sgk lhd rbd
vcf: zgh ghc bjh fpf
hjv: rqx
kcv: zxt rhl btn lhn
npq: fbr dsh hbm
flg: kcd ktg hmd
rgp: gqj jrr hmh jdg
hpx: ntb qbc
hqs: lpl
ptp: njx rrg rsq hqh
xzg: plb qsp
nts: lml lxs kxl
tqt: zrc hfs
jzm: ltc
xts: cmf gmj
zqh: pfq qdc
nmh: fkz vlj flf ndt
fbt: vbk
dhk: cnc
fhm: qxl xtd xnr
gxh: sxr dtc nff nvj
mdh: dbh zrq hsh nvj
rxb: nnk drb fcc
bkf: zlc fgv zfx
mbv: fph rxc bzr qdp bvr kmg
jkf: zmj zct
mns: xdq fbd
lqf: cxn qcv xpn
mmm: lzb cdh
kgh: hgl gxt gcq
bxn: ksg jdf cgn rls
jpb: frg
fhr: vqn
zxx: fhd pmd mtd qtn
lrj: qrq hmr jtm
dcv: lkl pzb zrt qjq jsp pnq
ddj: ndg kkt nkh
mxf: fmn xzx
clf: nnk nnn fgv
tdz: hsg bgs jvk
tsj: grm xcg fpd
zjb: hlz sts xcf
knr: dlp zfx
dlm: zcj vdd gxb gvg
ffg: mrs hxj
dpr: ncf qst nxx
ktv: mkk
svp: gct hqs lgl
xnk: btf
ppq: fnx vst frg
bts: skh lhs xsr btn cmf
snj: gmj kfj mns
tmx: rbx
dqp: ntb lhv jdv
smk: llr dvt tjj ddk
jlr: qgn
qdj: rxg snx
rnj: qdq jkn xbr qdc dlj
mbh: lzn cvz stn
vcd: ppz nch
xxt: gzg xhd hgl zcj
rsx: tcx sts kmv
mmg: qgt lts sjd znf
xgk: mfb
jmm: hzj tbs rvt lxt jnc
rhz: sdd
hhc: vlj jcd
jpr: jcm gcd
ngb: cgn gcz
nfj: hkh
xcd: mkb vqx nhg
jnc: xtd bxb
gtt: qvc qqz bjh qkb
lxb: cch szr mrq
vmk: srt
gpz: fbd
phz: bcj drb xts xlv
zlm: hzp hqs rsx
sgj: vns hkh
blf: hdt lhn qst
psk: fpb nnn qmv
jvm: zzn qvb
czp: mcn xlv
jtl: hdt xnp
fcl: ldn dmk ghk gxv kzx crl
xlf: brh sxr qlg jnp
nbs: vxr rvp ncf kmh ghc
jsn: glz crv vbp
nxd: lmf mxf vfk xqf
tdj: cmc kjl kfs fdn
zpr: cph hls
xbl: gmm lpx
rqt: gkl mzc
jvk: ggs
zkt: zqx vcd hrx dhv
vfl: kzn pxl
rvt: fxg vlj
kqv: txr ktg jdk hpk
hnz: gvj xcg dlp
ncj: jgc rkg shj
lch: cpd fxx rjj
mlg: qqx
pfk: dxq rgn mxs gtm hjm
mqf: rnf blh
tll: stx xxq brx zqx
grg: jcm rdc cnv vcg
qnr: bpg rlz kzn
stn: qbd sgr
bvt: kvp nbm ksg
gkp: ltl bcj npd
lrb: sxs bvr gfm vht shv
sld: rzp zmj qmn hmv
rpb: hkk
hsh: fsm
scr: vmx fsf ksz hvq mhg
rlt: kdz dhf
qvc: nvk
fvf: rtf jdz qxh nbb
kkb: ktv dbz zfq pcq
hfs: nch lfj
sft: hzh sbg jdg kqc cmc
mmc: dtq czr vfh
znc: rzt bpc cnt lss tqm
fgv: mgk
ljb: ljg bnm fsf cnm jgb ckp
cxm: mcn fcc zjl
ksz: mfb
xmb: rzp lxf xrl pcq
hkn: mzc
flk: kcd lxf mkk
xfl: hmf
bnv: rpd dbt
vqn: qjf
qpj: ckp hzf hxh
kzm: vvs ccz
cnt: pvd
mqv: lcn vfh phm kzx
jpx: rdt frf ftd
slk: hjt
hzh: cxx qdl ftz
plm: pcv vqh xph nvj
vvj: mtj lqh
chc: xpn tkf dqk
kjl: lks sbv
nvr: ncm fzr crf llh
nfs: dhf pcx
nhz: bgq
lpq: cjb hpx
qvs: nxx npt gld lqf
hmf: glf
cds: hvc qgt nzv nhq
xnf: dvc
tnb: sbc
gnv: bgq
jqp: jrq
krm: tcx fgq
ntc: skz jpr tgq vrb flc
bgs: gpl vnp mzz
rzp: hls
gkl: tvt
rmh: xsr rtf nhv
dhb: krh cfx dvz smk bhb ghk
src: gcd
glz: xhh
skz: gpp
ckp: dbk
zfn: qgd xph hzn nlc hkj
gcl: vnp mzq jtm grh
kds: fjp qxz hbm jdf
vgq: dzn vkn vvg lxt
gzz: lvn nzm gnv smr
psr: stx rgn qdj bjr
gpl: sdx
vvd: btp hqh ghr
fcq: gpz qcf
dlp: jnm ngx krd
jth: hkh npp
jnm: ltf cqg
ckr: zfq cnv
jqq: zhc
rdr: ljn xkn glb
xmp: npm mmm hbc hlk
bxd: pbp dhq
xxb: dhk dtc nhg
mzz: cdx sbt
dxs: qlg cnt jtx bbx
hmh: dms
fhc: zkj ktc dzq
xfs: rbd xvh hvr
jpj: xvx xgt fgv
rzt: dqm ztt jnp
vqx: kzq lfl htp
hpb: fct
hbt: cmn gtq lzb jlq
flz: mzc
zkg: trs qmh mqv hsz
jxt: flf
brr: xtn kxt ppd
djk: ptr vmd rcc
qzx: qcv vhv dvc rnf
pmh: tpd rkb shj
tcj: krm
gmt: dpc glz xjk bfb
qrq: gfr
fqb: mxs mgp ngd qvd stg tms
sbf: ttv hlz nzv
lcn: zct trs
vzp: nqg
rsg: bpc
ggd: zkg phn hpb qnr
xdn: gqf pjt jzs czp
qmn: ntd bhf
tkc: vmk hrc hgk ffs ntf
gqj: mxt mmk khn
dtv: xzs
frf: gld jlq
trn: jmn pmh kxt khz shp
xlm: dvc npb
smr: hcj
tsp: kvh fxg xzs
djn: hjs khm kcr
ppz: ktv brm flz
mph: bfp bzr clk zqh zlg
qrm: dhq
cvv: vjg grm ntn fhc
ncq: vqx tpd jnc fbv
vxr: snj qdp
ghq: tzd ftz jtm dlr
lks: ppd
xsm: gln jgs mhg
jgb: fxx ffs crv
fzh: lzl msz fzr cxn ksz
fmf: krc zrc fhr slf vbk
mhg: rht
xqf: gpz mzk xhh qgc
zhc: kvp
hkz: hkd crx mst npm hgk
rht: lfx
llr: nrh ldj
xbc: mtz srp qsf
ssj: qcs
hzx: cfx rpd ntd fct fmj
rmd: qvm xtn hkn
zhn: tsk drd nbv kfj
tlg: ppz bzg gmm vvg
mtj: kgd jgs
mdd: dnz rxr jxn
prs: csf qsp vjg jpl kfc
xxd: nkh hdl ppz
dvt: dtc
hbz: hhc dtq ksj
ddk: cbn dmk
ldj: nms hmr
fsh: srp ppx xzx
hbn: nhz mbh csp qnm
pnv: zfq
vdx: jjl tsd jpm
krh: mrf dnr
qdq: jjl
jtz: lqh qdd xpn rrm
qrj: mzx cgl
jdg: qrj
lrp: lpq gkv xxq
pgp: flz nmb fdn kdb
nhp: ltn
bkz: hqh vvg
nlc: qxc rvn pjj
rds: tzx cch mkg
xsj: mzx vpq
xrv: rsg bjr
rst: dvc
zsd: xvj rjj zqs
hgk: gcq
jdf: rch mfx lhs
txp: znk zrc mcv
hzj: fkz
fbs: zlg
xpx: hkd htj
bnc: rbx bfp hkx
hvr: xnf svt cxl
tqm: hzj znk
cht: tzx cps njj sqs kzg
shj: qgd
kdz: hgq njj
jzz: kvm snx
kbk: qrr
gnb: dvt dpk jlk lbz
dkb: hxj gch dkd jrr
fjt: cbg qhv
kfq: qrf
rpd: lss ppd
gxb: ncf